25 25
200 100
4 10 10 10 10 10 10 10 10 10 10 10 10 10 10 10 10 10 10 10 10 10 10 10 5
8 1  1  1  1  1  1  1  1  1  1  1  1  1  1  1  1  1  1  1  1  1  1  1  9
8 1  1  1  1  1  1  1  1  13 1  1  1  1  1  1  13 1  1  1  1  1  1  1  9
8 1  1  1  1  1  1  14 1  12 1  1  1  1  1  1  1  1  13 1  13 1  1  1  9
8 1  1  1  1  1  1  12 1  1  1  1  1  1  13 1  1  1  1  1  1  1  1  1  9
8 1  1  1  1  1  1  1  1  1  1  1  1  1  1  1  1  13 1  1  1  13 1  1  9
8 1  13 1  1  1  1  1  1  1  1  1  1  1  1  1  1  1  1  1  1  1  1  1  9
8 1  1  14 1  1  2  2  2  1  1  1  12 1  1  1  1  1  1  1  1  1  13 1  9
8 1  1  1  1  1  2  2  2  1  1  1  1  1  1  1  1  13 1  1  13 1  1  1  9
8 1  1  1  1  1  1  2  3  2  1  1  1  1  1  1  1  1  1  1  1  1  1  1  9
8 1  1  1  1  1  1  1  2  2  1  1  1  1  1  1  1  1  1  1  1  1  1  1  9
8 1  1  12 1  1  1  1  1  1  1  1  1  1  1  1  1  1  1  1  1  1  1  1  9
8 1  1  1  1  1  1  1  1  1  1  1  2  1  1  1  1  1  1  1  1  1  13 1  9
8 1  1  1  1  1  1  1  1  1  1  1  1  2  1  1  2  2  2  1  1  1  1  1  9
8 1  1  1  1  1  1  1  13 1  1  1  1  1  1  2  2  3  2  1  1  1  1  1  9
8 1  1  1  1  1  1  1  1  1  1  1  1  1  1  2  2  2  2  1  1  1  1  1  9
8 1  1  1  1  1  1  1  1  1  1  1  1  1  1  2  2  2  1  1  1  1  1  1  9
8 1  1  13 1  1  1  1  1  1  1  1  1  1  1  1  1  1  1  1  2  2  2  3  9
8 1  1  1  1  1  1  1  1  1  1  1  1  1  1  1  1  1  1  2  2  2  2  2  9
8 1  1  1  2  2  2  2  1  1  1  1  1  1  1  1  1  1  2  2  14 2  3  2  9
8 1  1  1  2  14 13 2  2  2  2  2  2  1  1  1  1  1  2  3  14 14 2  2  9
8 1  1  1  2  2  2  2  1  1  1  1  1  1  1  1  1  1  2  2  2  2  2  2  9
8 1  1  1  1  1  1  1  1  1  1  1  1  12 1  1  1  1  2  2  3  2  2  2  9
8 1  1  1  1  1  1  1  1  1  1  1  1  1  1  1  1  1  3  2  2  2  2  2  9
7 11 11 11 11 11 11 11 11 11 11 11 11 11 11 11 11 11 11 11 11 11 11 11 6